29 26
**#*********--************
*----*-----*--*-----*----*
*----*-----*--*-----*----*
*----*-----*--*-----*----*
**************************
----**--*--------*--*---**
-----*--*--------*--*----*
******--****--****--******
-----*-----*--*-----**----
-----*-----*--*-----------
-----*--**********--*-----
-----*--*--------*--*-----
-----*--*--------*--*-----
*********--------*********
-----*--*--------*--*-----
-----*--*--------*--*-----
-----*---*********--*-----
-----*--*--------*--*-----
-----*--*--------*--*-----
*****-******--************
*----*-----*--*-----*----*
*----*-----*--*-----*----*
***--****************--***
--*--*--*--------*--*--*--
--*--*--*--------*--*--*--
******--****--****--***-**
*----------*--*----------*
*----------*--*----------*
******$*******************
